0WWWWW0
WW000WW
W0YW00W
W00Y00W
W00X00W
WW0Y0WW
0WWWWW0
1,2
3,2
3,3
3,4
